BC	wtUMIs	mutUMIs
AGTAGCTGTCATCTAG	0	2
GTGAGCCCAGCATGCC	1	0
CATGCTCAGACTTCGT	1	0
AACAACCGTGCAGTGA	0	2
TCTTGCGGTGCCAAGA	0	1
ATTCACTCACTTGTGA	0	1
TATCTTGGTCTACGTA	2	0
TTCTGTATCCGTCCTA	1	0
GCGAGAAAGAGCTGCA	3	0
GTGAGGAAGGCGAACT	1	0
GGAGAACAGATGAACT	2	0
TACCCACCAAATGGTA	4	0
CATGAGTTCTGGACTA	2	0
GTTAGACTCTAGCCTC	2	0
GATTGGTAGCCTCTGG	1	0
TCCTAATCACCGCTAG	1	0
GAGTGTTCAACTAGAA	1	0
GTGGCGTGTGCTGCAC	0	1
CAGGCCATCAGTCACA	1	0
CGTTCTGGTGTCCGTG	2	0
CAACGATCATGAGATA	1	0
GTCGTAAGTGTTCAGT	1	0
GTCTAGAAGAGAGCAA	1	0
ACGGAAGGTAAGATTG	0	1
ACAGCCGAGAGTTGTA	3	0
TTTATGCCACTGGCCA	1	0
AACCTGATCATGGATC	0	1
ACTTTCAAGATCGGTG	1	0
CGAGAAGCAAACGTGG	1	0
TTACGCCTCTACTGAG	2	0
TGTTTGTGTGCTAGCC	0	1
ATGGGAGAGTGATGGC	1	0
TGGAGAGCAGTCGAGA	0	1
AATGGCTCAGCGGTCT	2	0
GGGTGAAGTCGCCTAG	1	0
TCGATTTGTGGGCTCT	1	0
GCATGATGTACAAGCG	1	0
CGCCAGAGTGACTATC	1	0
CTCCAACCACAATGAA	1	0
GGAGAACGTTCGAAGG	1	0
GCCCAGATCGCGGTAC	1	0
TCGGATAAGATCCAAA	0	1
GCCAGCACAAGGGCAT	1	0
TCCGGGACACCGTACG	1	0
TGTCCACCATGGCTGC	1	0
TCACAAGTCCATTGCC	1	0
TACGTCCAGAGCAGTC	0	1
TCATGTTCAATAAGGT	1	0
GAAGGGTTCCATTCGC	2	0
GAACTGTCAGTCTTCC	1	0
GTTACCCAGACCATAA	0	1
TGTTCTACAATTGAAG	0	1
TTTGATCGTACATTGC	0	2
GAGTTGTAGGTTAGTA	0	1
CAGATTGGTCGCACAC	0	1
GTGCTGGTCGCGTTTC	1	0
ACAGCCGCAAGCAGGT	1	0
AACTTCTAGCTGACAG	1	0
GGGATCCGTCGTGCCA	1	0
ACTATCTTCCTCAGAA	2	0
GGCTTGGTCACCTGGG	1	0
ATCACGAAGATGGGCT	2	0
TTGTGGACACGTTGGC	1	0
TGAGCGCAGCGTGTCC	1	0
GGTAACTGTTTACACG	1	0
GTAGCTATCCACGGAC	0	1
CAGCAATTCATTTCGT	1	0
AAGACAAAGTGGTTGG	1	0
CTCCTCCGTCCAAAGG	0	1
CGGACACGTACGACAG	2	0
GCCAGTGGTACCGTCG	1	0
AAAGTGATCGAGTGGA	1	0
CCGCAAGAGAGTTGTA	1	0
CTGATCCGTCGCAGTC	1	0
GATTCGACATGTGTCA	0	1
ACCACAAGTCAGTCTA	1	0
TTCTGTAGTTCATCTT	0	1
ATTGTTCCAGAGTCTT	1	0
GAAGCGAGTCACAATC	0	1
GGAGCAAAGATGGTCG	1	0
TGAGGAGTCCATAGAC	1	0
AGGGTCCTCACCTCGT	1	0
CTAACCCTCAAGAGGC	2	0
GGAACCCGTGTCCGTG	1	0
GTTAGTGTCCAACTAG	0	1
ACTGATGCATTGGATC	0	1
TGAATGCCAGGAACCA	1	0
ACCATTTGTTGCATTG	1	0
ACCCAAACACGCTTAA	0	1
TATATCCGTTGCTCCT	0	1
TTCTCTCGTAAGGCTG	2	0
CTTTCGGGTACGTGAG	0	1
AGTGTTGCAACCAGAG	1	0
CTACTATTCACTAGCA	0	1
GATGGAGGTGGCTGAA	1	0
CGGAATTCAGCTTTGA	1	0
GTCTAGAAGACAACAT	1	0
AAGACTCTCCTCGCAT	1	0
TTGTGGATCCGCGATG	1	0
TGGGATTAGAGCTGAC	0	1
AGCCAATGTTTGCAGT	0	1
CTCAGAACAGTTCCAA	1	0
ATCCCTGCACGCCACA	1	0
TGAATGCAGCCTCTGG	0	1
CTAGACACAGGATGAC	1	0
ACAAAGAGTGGAGGTT	1	0
CAACAACGTGAGTGAC	1	0
TCCTAATGTACTAAGA	0	1
CCAAGCGAGGTCGTCC	1	0
GCATTAGTCCATTCAT	1	0
TAACACGCACACACTA	1	0
TAAGTCGTCACCGACG	1	0
GAGTGAGTCGAGATGG	0	1
TTTGATCTCCTCTTTC	1	0
AAGCCATAGTCACGAG	1	0
CAGCAGCTCACAACCA	0	2
TCGCAGGTCTGTGCGG	1	0
CATTCATAGGTCCCTG	2	0
AGAAATGAGGAGGCAG	1	0
TAGACTGAGCCAACCC	1	0
CATGGATTCTGAGATC	1	0
CGGGTCATCCGGTAGC	1	0
ATGGAGGTCCGTTGGG	1	0
TGCATCCTCACGTAGT	1	0
CCCTCTCAGGCATCAG	0	1
TACTTGTAGCGACCCT	1	0
GAAGCGAAGTCGCCCA	0	1
TCTTTGACAGTGACCC	1	0
AAGCATCCAGCAAGAC	1	0
AATCGTGGTGCCTGAC	0	1
GAAGAATCAACGGCTC	0	2
TTGTGTTCAATTTCTC	0	1
GCCGTGAGTTGAATCC	1	0
GTAGCTATCACTGGTA	1	0
ATGCGATGTATTGCCA	1	0
CGTTGGGGTAACTGCT	1	0
GTTTGGAAGCCTGACC	2	0
AAGTGAAGTAGGCTCC	0	1
CCACCATAGAGGTTTA	1	0
TATTGCTTCCACGGAC	1	0
TCGACGGAGCAGTCTT	1	0
AAGCATCGTCCTGAAT	1	0
GACAGCCGTATTTCCT	1	0
GTCATCCCATTGCCGG	1	0
TATCTTGCAGGAGGAG	1	0
GAATCACAGACCCTTA	0	1
CTCACTGAGACGGTCA	1	0
CCGATCTGTTGGCTAT	0	1
GGTTGTACACACAGAG	0	1
AGTTCCCAGTCCTGTA	1	0
CTACATTCATACCACA	0	1
CTCGAGGAGTGCTCAT	0	1
TGACAGTAGTACGTCT	1	0
TAGCACACATAGGTAA	1	0
GGGACCTTCTGGTGCG	0	1
ACGATGTAGAACAGGA	1	0
GCGTTTCGTTGCGAAG	1	0
CTTTCGGGTAGTCCTA	1	0
GCTACCTAGCAACTTC	1	0
GACTTCCCATTGCAAC	0	1
CTGAGCGAGTGAGCCA	1	0
AAGCCATGTAATGCTC	1	0
AACCTGAAGCCGAATG	1	0
GAAGGACTCTGCCTCA	1	1
TGAACGTAGGTAGATT	0	1
CTGCTCAAGGCTCACC	1	0
CGATGCGCAAGCGAAC	1	0
GGTGTCGCATCAACCA	1	0
CCGCAAGCAAGTATCC	0	1
GCATCGGGTATCCCTC	0	1
CAATACGGTCCGACGT	0	1
CTTCTCTTCTTCGTAT	0	1
GCCGATGCAGGACTTT	0	1
GCGGAAACAATGCAGG	0	1
TCGCACTAGCGGTAGT	1	0
ATTTCACAGGGAACAA	0	1
CACGGGTTCCGCGGAT	1	0
TTAGGGTTCTTCACGC	0	1
CAACGATGTAGTGGCA	0	1
AAGGTAAGTAACATGA	1	0
ACCACAAGTAAGGCCA	0	1
CATTTCAAGACCGTTT	0	1
TACAACGAGACCATGG	1	0
TCCTCTTGTCCTCCTA	1	0
TCTTGCGTCTACCACC	1	0
TGCTTCGGTCATCCGG	1	0
ACTATCTTCTGTGCAA	0	1
AGCCAATAGGAACGAA	0	1
AGTGTTGAGGATGCGT	0	1
CAAGCTAAGTCCCGAC	0	1
CATACTTCATGGACAG	0	1
GTAAGTCAGACGGAAA	1	0
GTCGTAAGTCAAAGAT	0	1
TCATTCAAGTCATTGC	1	0
AACCAACCAGCTACTA	1	0
AGAACCTTCTCGCTTG	1	0
CCGTTCAAGATCCGAG	0	1
CGGAATTGTAAGGCTG	1	0
GCTTTCGAGCTGACAG	0	1
GTGAGTTCAACCTATG	1	0
GTGGTTATCCTCGCAT	0	1
TACAGGTAGACCCTTA	1	0
TAGACTGAGTTTGCTG	0	1
ACTACGACAGCGCGTT	0	1
AGGGTCCAGATCGACG	1	0
AGGTTACTCCAACTGA	1	0
ATGGGTTTCGAATGCT	1	0
CACACAACACCCGTAG	1	0
TTAGTCTCACAAGCCC	1	0
TTGGGTAGTGCGAGTA	1	0
ACGGTTACATCTTCGC	1	0
AGTCATGGTGCCTGCA	0	1
ATCACTTAGCAGGTCA	1	0
CATCAAGTCTTGAACG	1	0
GAGTCTAAGGTCATTC	0	1
GTCAAACCACTGCGAC	1	0
ACAAGCTTCCTGTTAT	0	1
CATGGTATCTTCACGC	1	0
CCATCACAGAGAACCC	0	1
CTCATGCAGTGATAAC	1	0
GCCCAGAGTTTCGGCG	0	1
GTTCGCTTCGCTGACG	1	0
TACGTCCTCCGCAAAT	0	1
ACCAACACATGTCAGT	0	1
CGAGTGCAGATAGTCA	0	1
CTTCGGTTCCACAGCG	1	0
GTAGCTAGTGTCATTG	0	1
GTCCCATGTTGGACCC	1	0
GTTCTATAGACTCTTG	0	1
TGCAGTACAACTGGTT	1	0
TTGTGTTTCTGTCGTC	0	1
CATCAAGCACCTGCGA	0	1
CCCTGATTCCTAGCGG	0	1
CGACAGCTCGCATAGT	1	0
CGGAATTGTAGCACAG	1	0
TACTTACAGAATAACC	1	0
TCTACCGTCTCCCTAG	0	1
TTGTGGATCCATTCGC	1	0
TTTCAGTTCATACGAC	0	1
